@#######################@
#==+                    #
#                       #
#                       #
#                       #
#                       #
#                       #
#                       #
#                       #
#                       #
#           #           #
#           #           #
#         ##@##         #
#           #           #
#           #           #
#                       #
#                       #
#                       #
#                       #
#                       #
#                       #
#                       #
#                       #
#                       #
@#######################@